@.#########
#..########
##....####
###.#.####
###.#..###
###.#.####
#####..###
#...##.#.#
#........#
#######...