.....#....
..##.#.####
.##..###..#
##....#...#
#.#.@.##..#
###..###..#
..#..#.#..#
.##.##.#.##
.#.......##
.#.....##
...#####